#potretbdg	lihat
@	di
7an	tujuan
ababil	abg labil
abdi	saya
abi	saya
abis	habis
acan	belum
acc	accord
achievment	penghargaan
ad	ada
adalh	adalah
adlah	adalah
adlh	adalah
admin	administrator
adoh	aduh
afaik	as far as i know
aha	tertawa
ahaha	haha
aing	saya
aj	saja
aja	saja
ajep-ajep	dunia gemerlap
ajib	asyik
ajj	saja
ak	saya
aka	dikenal juga sebagai
akang	kakak
akika	aku
akko	aku
akkoh	aku
akku	aku
akuwh	aku
akyu	aku
alay	norak
alhmdllah	alhamdulillah
aljasa	asal jadi saja
alow	halo
alus	bagus
ama	sama
ambilin	ambilkan
ambl	ambil
ameh	agar
ampir	hampir
ancur	hancur
and	dan
anjir	anjing
anjrit	anjing
ank	anak
anter	antar
antpni	antapani
anu	yang
ap	apa
ap2	apa-apa
apaan	apa
apartment	apartemen
apasih	apa sih
ape	apa
apes	sial
aplot	unggah
aps	apa
apva	apa
aq	saya
aqu	aku
aquwh	aku
ari	kalau
asa	rasa
asap	sesegera mungkin
asbun	asal bunyi
aseek	asyik
aseekk	asyik
asek	asyik
asekk	asyik
aseknya	asyiknya
asem	asam
asoy	asyik
aspal	asli tetapi palsu
astrojim	astagfirullahaladzim
astul	asal tulis
at	di
atanapi	atau
ath	kalau begitu
ati2	hati-hati
ato	atau
atuh	kalau begitu
au ah	tidak mau tahu
ava	avatar
awak	saya
award	penghargaan
aws	awas
ay	sayang
aya	ada
ayang	sayang
ayank	sayang
ayeuna	sekarang
ayok	ayo
b4	sebelum
back	kembali
bacot	banyak bicara
bade	akan
bakalan	akan
bales	balas
balihona	balihonya
bandes	bantuan desa
bangdes	pembangunan desa
bangedh	banget
bangkotan	tua
banpol	bantuan polisi
banpres	bantuan presiden
banpur	bantuan tempur
bansarkas	bantuan sarana kesehatan
bantosan	bantuan
bapa	bapak
bapa2	bapak-bapak
bapak2	bapak-bapak
baramaen	minta-minta
basbang	basi
baureksa	bahureksa
bazis	badan amal, zakat, infak, dan sedekah
bbk	babakan
bbrp	beberapa
bcanda	bercanda
bcoz	karena
bdg	bandung
beb	sayang
beca	becak
became	menjadi
because	karena
begajulan	nakal
begichu	begitu
begicu	begitu
begicyu	begitu
bejibun	banyak
bekas	harus
beliin	belikan
belom	belum
bencong	banci
bener	benar
benerin	benarkan
bentar	sebentar
ber2	berdua
ber3	bertiga
berdikari	berdiri di atas kaki sendiri
bere	beri
beresin	membereskan
bet	banget
bete	bosan
beti	beda tipis
beud	banget
beut	banget
bg	abang
bgd	banget
bgmn	bagaimana
bgs	bagus
bgt	banget
bhs	bahasa
bhubu	tidur
bijimane	bagaimana
bimbuluh	bimbingan dan penyuluhan
bintal	bimbingan mental
biofori	biopori
bip	bandung indah plaza
bisi	kalau-kalau
bkas	bekas
bkl	akan
bkn	bukan
bknnya	bukannya
bl	beli
blegug	bodoh
blg	bilang
blh	boleh
blk	balik
blkg	belakang
blm	belum
bln	bulan
blom	belum
bls	balas
blum	belum
bnchi	benci
bnci	benci
bngung	bingung
bnr	benar
bnran	yang benar
bnyk	banyak
bodor	lucu
bohay	badan aduhai
bokap	ayah
bokep	video porno
boker	buang air besar
bokin	pacar
bokis	bohong
bole	boleh
boljug	boleh juga
bolong	berlubang
bolot	bodoh
bonek	bocah nekat
bonyok	ayah ibu
boyeh	boleh
bpk	bapak
br	baru
brb	segera kembali
brg	bareng
briefing	pengarahan
brngkt	berangkat
bro	saudara laki-laki
brp	berapa
bru	baru
brur	saudara laki-laki
brwenang	berwenang
bs	bisa
bsa	bisa
bsen	bosan
bsk	besok
bsr	besar
bt	bosan sekali
bt	buat
btw	ngomong-ngomong
bu	ibu
bu_bu	tidur
buaya	tidak setia
bubarin	bubarkan
bubbu	tidur
buber	buka bersama
bubu	tidur
bujubune	luar biasa
bumil	ibu hamil
bunderan	bundaran
buser	buru sergap
bw	bawa
bwh	bawah
bwhn	bawahan
bwt	buat
by	oleh
byar	bayar
byk	banyak
byr	bayar
byrin	bayarkan
c8	chat
cabal	sabar
cabut	pergi
cadas	keren
caem	cakep
caem	tampan
cai	air
cakep	tampan
call	telepon
calo	makelar
cama-cama	sama-sama
can	bisa
cangcut	celana dalam
capcus	pergi
cape	capek
caper	cari perhatian
caur	jelek
ce	cewek
cek	periksa
cekak	tidak ada uang
cekal	cegah tangkal
cekidot	coba lihat
cemen	penakut
cemplungin	cemplungkan
cengengesan	tertawa
cengli	adil
ceper	pendek
cepet	cepat
ceu	kakak perempuan
cew	cewek
cewe	cewek
chuyunk	sayang
cibuk	sibuk
cilaka	celaka
cimeng	ganja
cin	cinta
cipika cipiki	cium pipi kanan cium pipi kiri
city	kota
ciye	cie
ciyh	sih
ciyus	serius
ckck	ck
ckepp	cakep
ckepp	tampan
ckp	cukup
ckp	tampan
ckp	cukup
clbk	cinta lama bersemi kembali
cmiiw	correct me if i'm wrong
cmn	hanya
cmpr	campur
cmpur	campur
cnenk	senang
cobi	coba
cong	banci
congor	mulut
conlok	cinta lokasi
cont	bersambung
cow	cowok
cowwyy	maaf
coz	karena
cp	siapa
cpa	siapa
cpe	capek
cpns	calon pegawai negera sipil
cppa	siapa
cppe	capek
cpt	cepat
cr	cara
cucok	cocok
cuek	tidak acuh
cuex	cuek
cuman	Cuma
cumi	Cuma miscall
cungkring	kurus tinggi
cups	culun
cupu	culun
curanmor	pencurian kendaraan bermotor
curas	pencurian dengan kekerasan
curcol	curahan hati colongan
curhat	curahan hati
cwek	cewek
cwok	cowok
cyin	cinta
cz	karena
d	di
daerh	daerah
dagh	sudah
dah	sudah
dalem	dalam
damang	sehat
damkar	pemadam kebakaran
dapet	dapat
dateng	datang
day	hari
de	adik
dech	deh
dek	adik
deket	dekat
demen	suka
dengerin	dengarkan
des	desember
deui	lagi
deyh	deh
dg	dengan
dgn	dengan
dh	deh
diancurin	dihancurkan
diantep	dibiarkan
dibalkot	di balai kota
dibdg	di bandung
dibelokan	dibelokkan
dibenerin	dibenarkan
dicek	diperiksa
didaerah	di daerah
digosipin	digosipkan
dijalan	di jalan
diknas	pendidikan nasional
dimaafin	dimaafkan
dimana	di mana
dimana2	dimana-mana
dimintak	diminta
dimna	di mana
dimna	dimana
dina	pada
dinten	hari
disdik	dinas pendidikan
disebelahnya	di sebelahnya
disekitar	di sekitar
disitu	di situ
diskitr	di sekitar
disono	di sana
distracip	dinas tata ruang dan cipta karya
diuber	dikejar
diwilayah	di wilayah
dket	dekat
dkit	sedikit
dkk	dan kawan-kawan
dkt	dekat
dl	dulu
dll	dan lain-lain
dlm	dalam
dlu	dulu
dmn	dimana
dngn	dengan
doang	saja
dodol	bodoh
doi	dia
doku	uang
don juan	playboy
dongs	dong
donk	dong
donlot	unduh
dpn	depan
dpt	dapat
dr	dari
dri	dari
drmana	darimana
drmn	darimana
drpd	daripada
drtd	dari tadi
dsb	dan sebagainya
dst	dan seterusnya
dstu	disitu
dtg	datang
dugem	dunia gemerlap
duh	aduh
duit	uang
duren	durian
dy	dia
ed	edisi
edan	gila
egp	emang gue pikirin
eike	aku
eke	aku
elo	kamu
elu	kamu
emang	memang
emangnya	memangnya
emergency	darurat
emg	memang
emng	memang
emte	makan teman
endah	indah
endak	tidak
engga	tidak
enggak	tidak
enjing	pagi
entar	nanti
envy	iri
enyak	iya
estuning	sungguh
eta	itu
etc	et cetera
ex	mantan
ext	extension
fax	facsimile
fb	facebook
fifo	first in first out
finek	finansial ekonomi
flow	aliran
folbek	follow back
folbek	follow balik
from	dari
fwd	diterukan
fyi	sebagai informasi
g	tidak
ga	tidak
gaada	tidak ada uang
gabisa	tidak bisa
gag	tidak
gahar	sangar
gaje	tidak jelas
gak	tidak
gak papa	tidak apa-apa
gakpapa	tidak apa-apa
gamau	tidak mau
gan	juragan
gandeng	berisik
gapapa	tidak apa-apa
gaptek	gagap teknologi
gatau	tidak tahu
gatek	gagap teknologi
gawe	kerja
gax	tidak
gbs	tidak bisa
gda	tidak ada uang
gdbage	gedebage
ge	juga
gebetan	orang yang disuka
geer	gede rasa
geje	tidak jelas
gelo	gila
genk	geng
gepeng	gelandangan dan pengemis
gera	cepat
getho	begitu
geto	begitu
geus	sudah
gg	gang
ghiey	lagi
ghiy	lagi
gi	lagi
gile	gila
giman	gigi mancung
gimana	bagaimana
gini	begini
gino	gigi nongol
gitchu	begitu
gitchu	gitu
gitcyu	begitu
githu	begitu
githu	gitu
gitu	begitu
gj	tidak jelas
gk	tidak
gmana	bagaimana
gmn	bagaimana
gn	begini
gni	begini
goblog	goblok
goblok	bodoh
gokil	gila
golput	golongan putih
gombal	suka merayu
gowes	mengayuh sepeda
gpl	tidak pakai lama
gpny	tidak punya
gpp	tidak apa-apa
gr	gede rasa
gretong	gratis
gretongan	gratisan
gt	begitu
gtau	tidak tahu
gtu	begitu
gtw	tidak tahu
gua	saya
gue	saya
guoblok	goblok
guys	teman-teman
gw	saya
gws	cepat sembuh
ha	tertawa
hadeuh	aduh
haghaghag	tertawa
haha	tertawa
hakhak	tertawa
hallow	halo
handak	bahan peledak
hankam	pertahanan dan keamanan
hansip	pertahanan sipil
haturnuhun	terima kasih
hawatos	khawatir
hehe	he
hellow	halo
helo	halo
helow	halo
hese	susah
heula	dahulu
heurin	penuh
hey	hai
hi	hai
hingga	sehingga
hlm	halaman
hlng	hilang
hny	hanya
hnya	hanya
hoax	isu bohong
houm	rumah
hoyong	ingin
hr	hari
hrg	harga
hrga	harga
hrs	harus
hrus	harus
htr	terima
hub	hubung
hubad	hubungan angkatan darat
hubdar	perhubungan darat
hubla	perhubungan laut
huff	mengeluh
huft	mengeluh
hum	rumah
humas	hubungan masyarakat
humz	rumah
hungkul	saja
idk	saya tidak tahu
ieu	ini
ilang	hilang
ilfeel	tidak suka
ilfil	tidak suka
imah	rumah
imah2	rumah-rumah
imb	ijin mendirikan bangunan
imba	jago sekali
imho	in my humble opinion
imoet	imut
imoetz	imut
info	informasi
informasina	informasinya
item	hitam
itung	hitung
itungan	hitungan
iy	iya
iye	iya
iyo	iya
ja	saja
jablay	jarang dibelai
jadiin	jadikan
jadul	jaman dulu
jaim	jaga image
jalan	jalan
jamkerja	jam kerja
jancuk	anjing
jayus	tidak lucu
jd	jadi
jdi	jadi
jdikan	jadikan
jem	jam
jeung	dan
jg	juga
jga	juga
jgn	jangan
jgnkan	jangankan
jijay	jijik
jir	anjing
jkt	jakarta
jl	jalan
jl.	jalan
jln	jalan
jln	jalan
jng	jangan
jnj	janji
jomblo	tidak punya pacar
jth	jatuh
jubir	juru bicara
jurdil	jujur adil
jutek	galak
jwb	jawab
k	ke
ka	kakak
kaayaan	keadaan
kab	kabupaten
kabag	kepala bagian
kabeh	semua
kabid	kepala bidang
kabor	kabur
kacian	kasihan
kacrut	kacau
kadit	kepala direktorat
kadiv	kepala divisi
kaga	tidak
kagak	tidak
kaka	kakak
kalo	kalau
kalo	kalau
kamari	kemarin
kampret	sialan
kamsud	maksud
kamtib	keamanan dan ketertiban
kamtibmas	keamanan dan ketertiban masyarakat
kamuh	kamu
kamuwh	kamu
kamyu	kamu
kang	kakak
kanwil	kantor wilayah
kapt	kapten
karna	karena
kasat	kepala satuan
kasubbag	kepala subbagian
kasubbid	kepala subbidang
katrok	kampungan
kau	kamu
kaya	seperti
kayak	seperti
kayanya	kayaknya
kb	kebun
kbakaran	kebakaran
kbar	kabar
kbn	kebun
kbr	kabar
kcian	kasihan
kdu	harus
kebon	kebun
keburu	terlanjur
kec	kecamatan
kec.	kecamatan
kedah	harus
kedubes	kedutaan besar
kejalan	ke jalan
kejurnas	kejuaraan nasional
kek	seperti
kekeuh	keras kepala
keknya	kayaknya
kel	kelurahan
keliatan	kelihatan
kemaren	kemarin
kenapa	mengapa
keneh	masih
kepengen	mau
kepikiran	terpikirkan
kepingin	mau
kepo	mau tahu urusan orang
kepsek	kepala sekolah
kere	tidak punya uang
kesbang	kesatuan bangsa
kesian	kasihan
kesra	kesejahteraan rakyat
ketauan	ketahuan
ketawa	tertawa
ketrima	diterima
keukeuh	keras kepala
keun	kan
kgiatan	kegiatan
khan	kan
kibul	bohong
kibus	kaki busuk
kidul	selatan
kieu	begini
kimpoi	kawin
kircon	kiaracondong
kitu	begitu
kiyeu	begini
kk	kakak
kk	kartu keluarga
kl	kalau
klian	kalian
klianz	kalian
klo	kalau
klompok	kelompok
kloter	kelompok terbang
kls	kelas
kluarga	keluarga
klw	kalau
klwrga	keluarga
km	kamu
kmari	kemari
kmh	bagaimana
kmps	kampus
kmpus	kampus
kmrn	kemarin
kn	kan
kna	atas
knal	kenal
knl	kenal
knlpot	knalpot
knp	kenapa
knpa	kenapa
kodya	kota madya
kog	kok
kok	mengapa
komdis	komisi disiplin
komo	bahkan
komp	kompleks
kompi	komputer
komplain	keluhan
komsov	komunis sovyet
komtiong	komunis Tiongkok
kongkow	kumpul bareng teman-teman
konjen	konsulat jenderal
kool	norak
kopdar	kopi darat
koq	kok
korbn	korban
korup	korupsi
kpd	kepada
kpn	kapan
kptsan	keputusan
krenz	keren
kresek	plastik
krg	kurang
krik	garing
krm	kirim
krn	karena
krna	karena
ks	kepala sekolah
kt	kita
ktauan	ketahuan
ktmu	ketemu
ktny	katanya
ktr	kantor
ku	oleh
kudu	harus
kukurilingan	keliling-keliling
kumaha	bagaimana
kuper	kurang pergaulan
kuq	kok
kurangny	kurangnya
kw	imitasi
ky	seperti
kyk	seperti
kykny	kayanya
la	lah
laka	kecelakaan
lam	salam
lamban	lambat
lambreta	lambat
lami	lama
lamp	lampiran
lansia	lanjut usia
lanud	landasan udara
lapas	lembaga pemasyarakatan
latgab	latihan gabungan
lbh	lebih
lbur	libur
lebay	berlebihan
lebet	masuk
leh	boleh
leh	boleh
lekong	laki-laki
lelet	lambat
lemot	lambat berfikir
lemot	lemah otak
lg	lagi
lgi	lagi
lgkp	lengkap
lgsg	langsung
lht	lihat
liat	lihat
light	lampu
linmas	perlindungan masyarakat
litbang	penelitian dan pengembangan
lmyan	lumayan
lmyn	lumayan
lngkp	lengkap
lo	kamu
loch	loh
loe	kamu
lol	tertawa
lola	lambat berfikir
lolobana	banyaknya
lom	belum
look	lihat
louph	cinta
loupz	cinta
low	kalau
lowh	kamu
lp	lupa
lu	kamu
luber	langsung, umum, bebas, dan rahasia
luchu	lucu
luchuw	lucu
luff	cinta
lum	belum
luph	cinta
luthu	lucu
lw	kamu
lwipanjang-lingkar	leuwipanjang-lingkar
lwipanjang	leuwipanjang
lwn	lawan
lwt	lewat
maacih	terima kasih
maaciw	terima kasih
mabal	bolos
mabes	markas besar
macem	macam
macem-macem	macam-macam
macih	masih
madesu	masa depan suram
maem	makan
maen	main
magabut	makan gaji buta
mahatma	maju sehat bersama
maho	homo
mak	ibu
mak jang	kaget
makasih	terima kasih
maksa	memaksa
maksain	memaksa
malah	bahkan
malem	malam
malu2in	memalukan
mam	makan
mampet	tersumbat
mamz	makan
maneh	kamu
mang	paman
manies	manis
maniez	manis
maniezt	manis
mantep	mantap
manya	masa
mao	mau
markus	makelar kasus
masi	masih
masukin	masukkan
masy	masyarakat
matak	menyebabkan
mau	mau
mba	mbak
mbl	mobil
melu	ikut
meminimalisir	meminimalkan
mending	lebih baik
meneketehe	mana kutahu
mengapa	mengapa
meni	sangat
mepet	dekat sekali
mgg	minggu
mgkn	mungkin
mgu	minggu
mhn	mohon
miapah	demi apa
migas	minyak dan gas bumi
miker	minuman keras
mikol	minuman beralkohol
milis	mailing list
min	administrator
miras	minuman keras
mjd	menjadi
mksd	maksud
mkan	makan
mkanan	makanan
mkn	makan
mknan	makanan
mlah	malah
mls	malas
mluap	meluap
mmbuat	membuat
mnggnkn	menggunakan
mngkn	mungkin
mnjd	menjadi
mnt	minta
mnurt	menurut
mnylsikn	menyelesaikan
mo	mau
moal	tidak akan
moge	motor gede
mokad	mati
mokat	mati
morning	pagi
moso	masa
mosok	masa
mpe	sampai
mrk	merek
msh	masih
msk	masuk
mskpn	meskipun
mslh	masalah
msng2	masing-masing
mt	makan teman
mtr	motor
muahal	mahal
mubes	musyawarah besar
muker	musyawarah kerja
mulu	melulu
mumet	pusing
mumpung	selagi
mun	jika
muna	munafik
munas	musyawarah nasional
munaslub	musyawarah nasional luar biasa
muntaber	muntah dan berak
musda	musyawarah daerah
musti	mesti
muup	maaf
muupz	maaf
muuv	maaf
mw	mau
mw	now watching
n	dan
na	nya
naha	mengapa
nal	kenal
nanam	menanam
nangis	menangis
nanya	bertanya
naon	apa
napa	kenapa
napa	kenapa
napi	narapidana
napol	narapidana politik
napza	narkotika, alkohol, psikotropika, dan zat adiktif 
naq	anak
narkoba	narkotika, psikotropika, dan obat terlarang
narsis	bangga pada diri sendiri
nasgor	nasi goreng
nax	anak
nda	tidak
ndak	tidak
ndiri	sendiri
ndut	gendut
ne	ini
negeri	negara
nekolim	neokolonialisme
nekolin	neokolonialisme
nelfon	menelepon
nembak	menyatakan cinta
nga	tidak
ngabis2in	menghabiskan
ngabuburit	menunggu berbuka puasa
ngakak	tertawa
ngaku	mengaku
ngalir	mengalir
ngambek	marah
ngambil	mengambil
ngamen	mengamen
ngampus	pergi ke kampus
ngan	hanya
ngangge	menggunakan
nganggur	tidak punya pekerjaan
ngantri	mengantri
ngapah	kenapa
ngapain	sedang apa
ngaret	terlambat
ngaruh	berpengaruh
ngasih	memberikan
ngawur	berbicara sembarangan
ngebandel	berbuat bandel
ngeceng	kumpul bareng-bareng
ngegosip	bergosip
ngeh	sadar
ngeklaim	mengklaim
ngekos	tinggal di kos
ngeksis	menjadi eksis
ngelamar	melamar
ngelem	mengelem
ngeles	berkilah
ngeliat	melihat
ngelidur	menggigau
ngemeng	bicara terus-terusan
ngerampok	merampok
ngerti	mengerti
ngetem	berhenti
ngga	tidak
nggak	tidak
ngibul	berbohong
ngikut	ikut
ngiler	mau
nginep	menginap
ngiri	iri
ngisi	mengisi
ngisiin	mengisikan
ngmg	bicara
ngmng	bicara
ngocol	lucu
ngocor	mengalir
ngocorna	mengalirnya
ngomong	bicara
ngomongin	membicarakan
ngubek2	mencari-cari
ngumpul	berkumpul
nguras	menguras
ngurus	mengurus
nhn	terima kasih
ni	ini
nice	bagus
nie	ini
niech	nih
nih	ini
nimbrung	ikut serta
nimpa	menimpa
niyh	nih
nkah	nikah
nmor	nomor
nmr	nomor
nnti	nanti
nntn	nonton
no	nomor
no	nomor
nobar	nonton bareng
nomer	nomor
nongkrong	kumpul-kumpul
np	now playing
nrp	narapidana
ntar	nanti
ntar	sebentar
ntn	nonton
nu	yang
nuhun	terima kasih
nuju	sedang
numpuk	bertumpuk
nunggu	menunggu
nutupin	menutupi
nyadap	sadap
nyak	nya
nyampah	membuat sampah
nyari	mencari
nyariin	mencari
nyekar	menyekar
nyiapin	mempersiapkan
nyicil	mencicil
nyiram	menyiram
nyoblos	mencoblos
nyok	ayo
nyokap	ibu
nyuhunkeun	meminta
o/	oleh
ogah	tidak mau
oge	juga
ok	ok
ol	online
omdo	omong doang
ongkir	ongkos kirim
oon	bodoh
oot	out of topic
org	orang
org2	orang-orang
orkes	olahraga dan kesehatan
ormas	organisasi masyarakat
ortu	orang tua
ospek	orientasi studi dan pengenalan kampus
otda	otonomi daerah
otre	ok
otw	on the way, sedang di jalan
p	bapak
pa	apa
pa	bapak
pacal	pacar
pahe	paket hemat
pak	bapak
pake	pakai
pakek	pakai
pala	kepala
pami	kalau
panja	panitia kerja
pansus	panitia khusus
pantesan	pantas
pantura	pantai utara
parpol	partai politik
pas2an	pas-pasan
pasopati	pasupati
pasutri	pasangan suami istri
patas	cepat dan terbatas
payun	depan
pd	pada
pdam	Perusahan daerah air minum
pdhl	padahal
pede	percaya diri
pelatda	pemusatan latihan daerah
pelatnas	pemusatan latihan nasional
pembiaran	dibiarkan
pembokat	pembantu
pemda	pemerintah daerah
pemilu	pemilihan umum
pemkot	pemerintah kota
pemprov	pemerintah provinsi
pemred	pemimpin redaksi
pengen	ingin
penjas	pendidikan jasmani
penmas	pendidikan masyarakat
per3an	pertigaan
perda	peraturan daerah
perek	wanita tuna susila
perhatiin	perhatikan
perkawis	perkara
pertamax	pertama
pesenan	pesanan
pesenin	pesankan
pgang	pegang
pgi	pergi
pi	tapi
pic	gambar
pijetin	pijitkan
pilkada	pemilihan kepala daerah
pimpro	pemimpin proyek
ping	tanggal
pisan	sangat
pisgor	pisang goreng
pjalan	pejalan
pju	penerangan jalan umum
pk	jam
pke	pakai
pkl	pedagang kaki lima
plat	pelat
plg	paling
pln	perusahaan listrik negara
pm	private message
pmrnth	pemerintah
pns	pegawai negara sipil
pns-nya	pegawai negara sipilnya
pntn	permisi
pny	punya
pnyrangan	penyerangan
pnyrg	penyerang
poek	gelap
polantas	polisi lalu lintas
polwan	polisi wanita
pondasi	fondasi
ponpes	pondok pesantren
ponsel	telepon seluler
pp	pamong praja
pp	pulang pergi
ppa	apa
prg	pergi
priksa	periksa
prjlnan	perjalanan
prkir	parkir
prnh	pernah
pro	profesional
psen	pesan
psn	pesan
psr	pasar
pst	pasti
psti	pasti
pswt	pesawat
ptr	putar
puanas	panas
pungli	pungutan liar
punten	permisi
pw	posisi nyaman
qmo	kamu
qmu	kamu
qt	kita
rada	agak
rakor	rapat koordinasi
rame	ramai
ranmor	kendaraan bermotor
raport	rapor
rapot	rapor
raskin	rakyat miskin
re	reply
rea	banyak
red	redaksi
ref	referensi
reg	register
rehab	rehabilitasi
rejeki	rezeki
rempong	sulit
renstra	rencana strategis
repp	balas
reskrim	reserse kriminal
respon	respons
restik	reserse narkotika
retwit	RT
rhs	Rahasia
rhs	rahasia
rmbt	rambut
rmh	rumah
rofl	rolling on the floor laughing
rshs	rumah sakit hasan sadikin
rt@infobdg	rt @infobandung
ru	baru
rudal	peluru kendali
ruko	rumah toko
rumh	rumah
rusun	rumah susun
rusunawa	rumah susun sewa
rutan	rumah tahanan
ruz	terus
rw	Rukun Warga
s4	sempat
sae	bagus
saia	saya
saiank	sayang
sajam	senjata tajam
sakali	sekali
sakedik	sedikit
salting	salah tingkah
saltum	salah kostum
sami	sama
sampe	sampai
sampeyan	anda
samph	sampah
samsek	sama sekali
sanes	bukan
sapa	siapa
sapose	siapa
sareng	bersama
satkorlak	satuan koordinator pelaksana
satpam	satuan pengamanan
satpol	satuan kepolisian
satuju	setuju
sawahna	sawahnya
say	sayang
sbb	sebagai berikut
sbg	sebagai
sbgai	sebagai
sbh	sebuah
sblh	sebelah
sblm	sebelum
sbnrny	sebenarnya
scara	secara
scr	secara
sd	sekolah dasar
sdg	sedang
sdgkn	sedangkan
sdh	sudah
sdkt	sedikit
sdn	sekolah dasar negera
sdngkn	sedangkan
se7	setuju
seabrek	banyak
sebelas dua belas	mirip
sebrang	seberang
seeur	banyak
segini	begini
sekjen	sekretaris jenderal
sembako	sembilan bahan pokok
sempak	celana dalam
sempet	sempat
sempet2nya	sempat-sempatnya
sendratari	seni drama tari
sering	sering
sertijab	serah terima jabatan
service	pelayanan
setubuh	setuju
sgt	sangat
sgtunya	segitunya
shg	sehingga
sidak	inspeksi mendadak
siech	sih
sieyh	sih
sikon	situasi dan kondisi
simpedes	simpanan pedesaan
sinetron	sinema elektronik
sip	ok
siramin	siramkan
sis	kakak perempuan
sj	saja
skali	sekali
skalian	sekalian
skarang	sekarang
skl	sekali
sklh	sekolah
sklmpok	sekelompok
skola	sekolah
skrg	sekarang
skt	sakit
skul	sekolah
slalu	selalu
slesai	selesai
slh	salah
slhsatu	salah satu
sll	selalu
slm	salam
slma	selama
slmt	selamat
slsai	selesai
slt	sulit
sma	sekolah menengah atas
smbarangan	sembarangan
smpah	sampah
smph	sampah
smpt	sempat
smua	semua
smw	semua
smwny	semuanya
sndiri	sendiri
sng	senang
so	jadi
soalnya	karena
soeta	soekarno hatta
sok	biasanya
soljum	sholat jumat
somse	sombong sekali
songong	sombong
sorry	maaf
sory	maaf
sosbud	sosial-budaya
sosek	sosial-ekonomi
sospol	sosial-politik
sotoy	sok tahu
sowry	maaf
spa	siapa
spanjang	sepanjang
spd	sepeda
sppa	siapa
sprti	seperti
spt	seperti
spy	supaya
srg	sering
srng	sering
srtfkt	sertifikat
stelah	setelah
stiap	setiap
stiap	setiap
stlh	setelah
stop	hentikan
stopan	setopan
stuju	setuju
subbag	subbagian
sudah	sudah
suk	masuk
sumbangin	sumbangkan
sumpek	sempit
supados	agar
sutralah	sudahlah
sy	saya
syg	sayang
syp	siapa
t4	tempat
tabanas	tabungan pembangunan nasional
tabuh	jam
tajir	kaya
tak	tidak
tapi	tetapi
tar	nanti
tau	tahu
taun	tahun
taw	tahu
tawh	tahu
tb	tubagus
td	tadi
tdi	tadi
tdk	tidak
te2p	tetap
tekor	rugi
telat	terlambat
telkom	telekomunikasi
telmi	telat berpikir
telp	telepon
telpon	telepon
temen	teman
temen2	teman-teman
tengil	menyebalkan
tengok	menjenguk
tepar	terkapar
terangkut	dapat diangkut
terbitin	terbitkan
tertibkaan	tertibkan
tetep	tetap
teu	tidak
tggu	tunggu
tgl	tanggal
tgu	tunggu
th	tahun
thanks	terima kasih
thankz	terima kasih
thd	terhadap
thdp	terhadap
thn	tahun
thx	terima kasih
ti	dari
tiasa	bisa
tidak	tidak
tihang	tiang
tilang	bukti pelanggaran
tilpun	telepon
tipi	TV
tipiwan	TVOne
tjebak	terjebak
tkg	tukang
tkp	tempat kejadian perkara
tks	terima kasih
tl	lampu lalu lintas
tlg	tolong
tll	terlalu
tlong	tolong
tlp	telepon
tlpn	telepon
tls	tulis
tman	teman
tmb	trans metro bandung
tmbah	tambah
tmbh	tambah
tmen2	teman-teman
tmn	teman
tmn2	teman-teman
tmpah	tumpah
tmph	tumpah
tmpt	tempat
tnda	tanda
tngh	tengah
tngu	tunggu
tnh	tanah
tnyta	ternyata
togel	toto gelap
tokai	tai
tokai	tai
tong	jangan
tos	sudah
toserba	toko serba ada
tp	tapi
tp	tetapi
tpi	tapi
tps	tempat pembuangan sampah
tq	terima kasih
trdhulu	terdahulu
trgntg	tergantung
trima	terima kasih
trims	terima kasih
trjd	terjadi
trm	terima
trmksh	terima kasih
trnyt	ternyata
trowongan	terowongan
trs	terus
trus	terus
trutama	terutama
trz	terus
ts	penulis
tsb	tersebut
tst	tahu sama tahu
ttd	tertanda
ttg	tentang
ttp	tetap
tu	itu
tuch	tuh
tuh	itu
tuir	tua
tumaros	tanyakan
tuwh	tuh
tw	tahu
tyap	tiap
u	kamu
u	untuk
u/	untuk
ud	sudah
uda	sudah
udah	sudah
udh	sudah
ujg	ujung
ujung2nya	ujung-ujungnya
ul	ulangan
ulah	jangan
ultah	ulang tahun
umk	upah minimum kota
un	ujian negara
unyu	lucu
unyu	menggemaskan
upami	kalau
uplot	unggah
uppu	apa
urang	saya
urg	saya
usah	perlu
usiran	usir
utang	hutang
utk	untuk
utul	ujian tertulis
valas	valuta asing
vege	vegetarian
view	pemandangan
vol	volume
w/	dengan
wad	buat
wadir	wakil direktur
wae	saja
wagub	wakil gubernur
wamil	wajib militer
waria	wanita pria
warkop	warung kopi
warnet	warung internet
warteg	warung tegal
wartel	warung telekomunikasi
wat	buat
we	saja
weh	saja
wengi	malam
wk	tertawa
wkt	waktu
wkwk	tertawa
wtf	what the fuck
wth	what the hell
xixixi	tertawa
y	kenapa
y	nya
ya	iya
yaa	iya
yach	iya
yad	yang akan datang
yap	iya
yapz	iya
yaudah	ya sudah
yauwda	ya sudah
yawdah	ya sudah
ybs	yang bersangkutan
yg	yang
yi	yaitu
yl	yang lain
yng	yang
yo	iya
yoha	iya
you	kamu
yowes	ya sudah
yth	yang terhormat
yuk	ayo
yup	iya
ywdh	ya sudah
